................................
................................
................................
................................
................................
................................
................................
................................
................................
................................
................................
................................
................................
................................
................................
................................
................................
BBBBBBBBBBBBBBBBBBBBBBBBBBBBBBBB
BBBBBBBBBBBBBBBBBBBBBBBBBBBBBBBB
................................
................................
................................
................................
................................
................................
................................
BBBBBB..........................
BBBBBB..........................
................................
................................
................................
................................
...BB......................BB...
...BB......................BB...
................................
................................
................................
................................
................................
................................
................................
...BB......................BB...
...BB......................BB...
................................
................................
................................
................................
................................
................................
................................
................................
................................
................................
................................
................................
................................
BBBBBBBBBBBBBBBBBBBBBBBBBBBBBBBB
BBBBBBBBBBBBBBBBBBBBBBBBBBBBBBBB
................................
................................
...BBBBBB...BBBBBBBB...BBBBBB...
...BBBBBB...BBBBBBBB...BBBBBB...
...BBBBBB...BBBBBBBB...BBBBBB...
................................
................................
BBBBBBBBBBBBBBBBBBBBBBBBBBBBBBBB
BBBBBBBBBBBBBBBBBBBBBBBBBBBBBBBB
................................
................................
................................
................................
................................
................................
....BBBB................BBBB....
....BBBB.......BB.......BBBB....
...............BB...............
................................
......BBBB............BBBB......
......BBBB............BBBB......
......BB................BB......
......BB................BB......
................................
................................
................................
................................
....BB..........................
....BB..........................
................................
................................
................................
................................
....BBBBBB..BBBBBB..BBBBBB......
....BB..BB..BB..BB..BB..BB......
....BB..BB..BB..BB..BB..BB......
................................
................................
................................
................................
................................
................................
................................
.....BB..BB..BB..BB..BB..BB.....
.....BB..BB..BB..BB..BB..BB.....
................................
................................
...BB..BB..BB..BB..BB..BB.......
...BB..BB..BB..BB..BB..BB.......
................................
................................
BBBBBBBBBBBBBBBBBBBBBBBBBBB.....
BBBBBBBBBBBBBBBBBBBBBBBBBBB.....
................................
................................
................................
................................
................................
................................
................................
................................
................................
................................
BBBBBBBBBBBBBBBBBBBBBBBBBBBBBBBB
BBBBBBBBBBBBBBBBBBBBBBBBBBBBBBBB
GGGGGGGGGGGGGGGGGGGGGGGGGGGGGGGG
GGGGGGGGGGGGGGGGGGGGGGGGGGGGGGGG
GGGGGGGGGGGGGGGGGGGGGGGGGGGGGGGG
GGGGGGGGGGGGGGGGGGGGGGGGGGGGGGGG
