................................
................................
................................
................................
................................
................................
................................
................................
................................
................................
................................
................................
................................
................................
................................
BBBBBBBBBBBBBBBBBBBBBBBBBBBBBBBB
BBBBBBBBBBBBBBBBBBBBBBBBBBBBBBBB
................................
................................
................................
................................
................................
................................
................................
................................
................................
................................
BBBBBBBBBBBBBBBBBBBBBBBBBBBBBBBB
BBBBBBBBBBBBBBBBBBBBBBBBBBBBBBBB
..BBBBBBBB....BBBB....BBBBBBBB..
..BBBBBBBB....BBBB....BBBBBBBB..
..............BBBB..............
..............BBBB..............
BB......BBBB........BBBB......BB
BB......BBBB........BBBB......BB
........BB............BB........
........BB............BB........
................................
................................
...BB.....BBBBBBBBBBBB.....BB...
...BB.....BBBBBBBBBBBB.....BB...
................................
................................
................................
................................
................................
................................
................................
................................
................................
................................
................................
................................
................................
................................
BBBBBBBBBBBBBBBBBBBBBBBBBBBBBBBB
BBBBBBBBBBBBBBBBBBBBBBBBBBBBBBBB
....BB........BBBB........BB....
....BB........BBBB........BB....
................................
................................
BBBB..BBBBBBBB....BBBBBBBB..BBBB
BBBB..BBBBBBBB....BBBBBBBB..BBBB
..........BB........BB..........
..........BB........BB..........
................................
................................
BBBBBBBBBB..BBBBBBBB..BBBBBBBBBB
BBBBBBBBBB..BBBBBBBB..BBBBBBBBBB
....BB........BBBB........BB....
....BB........BBBB........BB....
................................
................................
BBBB..BBBBBBBB....BBBBBBBB..BBBB
BBBB..BBBBBBBB....BBBBBBBB..BBBB
................................
................................
................................
................................
................................
................................
................................
BBBBBB....BBBBBBBBBBBB....BBBBBB
BBBBBB....BBBBBBBBBBBB....BBBBBB
................................
................................
................................
................................
................................
................................
................................
.....BBBBBBBBBBBBBBBBBBBBBB.....
.....BBBBBBBBBBBBBBBBBBBBBB.....
.....BB.......BBBB.......BB.....
.....BB.......BBBB.......BB.....
.....BB.......BBBB.......BB.....
.....BB.......BBBB.......BB.....
................................
................................
.....BBBBBBBBBBBBBBBBBBBBBB.....
.....BBBBBBBBBBBBBBBBBBBBBB.....
.......BBBB..........BBBB.......
.......BBBB..........BBBB.......
................................
................................
.....BBBBBBBBBBBBBBBBBBBBBB.....
.....BBBBBBBBBBBBBBBBBBBBBB.....
................................
................................
................................
..BBBB....................BBBB..
..BBBB....................BBBB..
..BB........................BB..
..BB........................BB..
BBBB..BB..BBBBBBBBBBBB..BB..BBBB
BBBB..BB..BBBBBBBBBBBB..BB..BBBB
................................
................................
.....BBBBBBBBBB..BBBBBBBBBB.....
.....BBBBBBBBBB..BBBBBBBBBB.....
.....BB......BB..BB......BB.....
.....BB......BB..BB......BB.....
................................
................................
................................
................................
BBBBBBBBBBBBBBBBBBBBBBBBBBBBBBBB
BBBBBBBBBBBBBBBBBBBBBBBBBBBBBBBB
GGGGGGGGGGGGGGGGGGGGGGGGGGGGGGGG
GGGGGGGGGGGGGGGGGGGGGGGGGGGGGGGG
GGGGGGGGGGGGGGGGGGGGGGGGGGGGGGGG
GGGGGGGGGGGGGGGGGGGGGGGGGGGGGGGG
