................................
................................
................................
................................
................................
................................
................................
................................
.....BBB..BBB.....BBB..BBB......
.....BBB..BBB.....BBB..BBB......
................................
................................
...BB...BB....BBB....BB...BB....
...BB...BB....BBB....BB...BB....
................................
................................
.....BBB..BBB.....BBB..BBB......
.....BBB..BBB.....BBB..BBB......
................................
................................
................................
BBBBBBBBBBBBBBBBBBBBBBBBBBBBBBBB
BBBBBBBBBBBBBBBBBBBBBBBBBBBBBBBB
................................
................................
................................
BBBBBBBBBBBBBBBBBBBBBBBBBBBBBBBB
BBBBBBBBBBBBBBBBBBBBBBBBBBBBBBBB
................................
................................
....BBBB................BBBB....
....BBBB................BBBB....
................................
................................
........BBBB....BBBB......BBBBBB
........BBBB....BBBB......BBBBBB
................................
................................
....BBBB................BBBB....
....BBBB................BBBB....
................................
................................
....BBBB....BBBB....BBBB....BBBB
....BBBB....BBBB....BBBB....BBBB
................................
................................
........BBBB....BBBB......BBBBBB
........BBBB....BBBB......BBBBBB
................................
................................
....BBBB....BBBB....BBBB........
....BBBB....BBBB....BBBB........
................................
................................
........BBBB....BBBB........BBBB
........BBBB....BBBB........BBBB
................................
................................
BBBBBBBBBBBBBBBBBBBBBBBBBB......
BBBBBBBBBBBBBBBBBBBBBBBBBB......
................................
................................
................................
................................
................................
................................
................................
....BB..BB..BB..BB..BB..BB......
....BB..BB..BB..BB..BB..BB......
................................
................................
......BB..BB..BB..BB..BB........
......BB..BB..BB..BB..BB........
................................
................................
....BB..BB..........BB..BB......
....BB..BB..........BB..BB......
................................
................................
..BB..BB..............BB..BB....
..BB..BB..............BB..BB....
................................
................................
BB..BB..................BB..BB..
BB..BB..................BB..BB..
................................
................................
................................
..BB..BB..BBBBBBBBBB..BB........
..BB..BB..BBBBBBBBBB..BB........
................................
................................
..BBBB..BB..........BB..BBBB....
..BBBB..BB..........BB..BBBB....
................................
................................
BB............BBBBBBBB..BBBBBBBB
BB............BBBBBBBB..BBBBBBBB
BB............BB........BB......
BB............BB........BB......
..............BB........BB......
..............BB........BB......
..............BB........BB......
....BB..........................
....BB..........................
................................
................................
................................
................................
................................
................................
..........BBBBBBBBBBBBBBBBBBBBBB
..........BBBBBBBBBBBBBBBBBBBBBB
................................
................................
................................
................................
BBBBBBBBBBBBBBBBBBBBBBBBBBBBBBBB
BBBBBBBBBBBBBBBBBBBBBBBBBBBBBBBB
................................
................................
................................
................................
..............................BB
..............................BB
................................
................................
...BBBBBBBBBBBBBBBBBB...........
...BBBBBBBBBBBBBBBBBB...........
................................
................................
................................
................................
................................
................................
...BBBB...BBBB...BBBB....BBBB...
...BBBB...BBBB...BBBB....BBBB...
................................
................................
................................
BBBBBBBBBBBBBBBBBBBBBBBBBBBBBBBB
BBBBBBBBBBBBBBBBBBBBBBBBBBBBBBBB
................................
................................
................................
................................
................................
...BBBB..........BBBB...........
...BBBB..........BBBB...........
................................
................................
................................
.........................BBBB...
.........................BBBB...
................................
................................
................................
................................
BBBB......BBBBBBBB..........BBBB
BBBB......BBBBBBBB..........BBBB
..BB......BB....BB..............
..BB......BB....BB..............
................................
................................
....BBBBBB........BBBBBBBB..BBBB
....BBBBBB........BBBBBBBB..BBBB
........................BB......
........................BB......
.............BB.................
.............BB.................
................................
................................
BBBB........BBBB........BBBBBBBB
BBBB........BBBB........BBBBBBBB
................................
................................
....BBBBBBBB....BBBBBBBBBBBBBBBB
....BBBBBBBB....BBBBBBBBBBBBBBBB
....BB....BB....BB..............
....BB....BB....BB..............
....BB....BB....BB..............
....BB....BB....BB..............
................................
................................
......BBBB........BBBBBBBB......
......BBBB........BBBBBBBB......
................................
................................
................................
................................
........BBBB....BBBB............
........BBBB....BBBB............
..........................BBBBBB
..........................BBBBBB
................................
................................
BBBBBBBBBBBBBBBBBBBBBBBBBBBBBBBB
BBBBBBBBBBBBBBBBBBBBBBBBBBBBBBBB
GGGGGGGGGGGGGGGGGGGGGGGGGGGGGGGG
GGGGGGGGGGGGGGGGGGGGGGGGGGGGGGGG
GGGGGGGGGGGGGGGGGGGGGGGGGGGGGGGG
GGGGGGGGGGGGGGGGGGGGGGGGGGGGGGGG
