................................
................................
................................
................................
................................
................................
................................
................................
................................
................................
................................
................................
................................
................................
................................
BBBBBBBBBBBBBBBBBBBBBBBBBBBBBBBB
BBBBBBBBBBBBBBBBBBBBBBBBBBBBBBBB
BBBB........................BBBB
BBBB........................BBBB
BB............................BB
................................
................................
................................
................................
...BB...BB...BB..BB...BB...BB...
...BB...BB...BB..BB...BB...BB...
................................
................................
................................
................................
................................
BBBBB........BBBBBB........BBBBB
BBBBB........BBBBBB........BBBBB
................................
................................
......BB................BB......
......BB................BB......
......BB................BB......
......BB................BB......
......BB................BB......
......BB................BB......
......BB...BBBBBBBBBB...BB......
......BB...BBBBBBBBBB...BB......
BBBB........................BBBB
BBBB........................BBBB
BB............................BB
BB............................BB
BB............................BB
BB............................BB
................................
................................
BBBBBBBBBB..BB....BB..BBBBBBBBBB
BBBBBBBBBB..BB....BB..BBBBBBBBBB
................................
................................
................................
................................
................................
BBBBBBBBBBBBBBBBBBBBBBBBBBBBBBBB
BBBBBBBBBBBBBBBBBBBBBBBBBBBBBBBB
......BB................BB......
......BB................BB......
......BB................BB......
......BB................BB......
................................
................................
................................
................................
.........BBBBBBBBBBBBBB.........
.........BBBBBBBBBBBBBB.........
BBBB.....BB..........BB.....BBBB
BBBB.....BB..........BB.....BBBB
..BB.....BB..........BB.....BB..
..BB.....BB..........BB.....BB..
..BB.....BB..........BB.....BB..
..BB.....BB..........BB.....BB..
.........BB..........BB.........
.........BB..........BB.........
BBBBBBB..BB..BB..BB..BB..BBBBBBB
BBBBBBB..BB..BB..BB..BB..BBBBBBB
................................
................................
................................
................................
................................
................................
................................
................................
................................
.........BBB....................
.........BBB....................
................................
................................
................................
................................
................................
................................
................................
................................
................................
................................
................................
................................
................................
................................
................................
................................
................................
................................
................................
................................
................................
................................
................................
................................
................................
................................
................................
................................
................................
................................
................................
................................
................................
................................
................................
................................
................................
................................
................................
................................
................................
................................
................................
................................
................................
................................
................................
................................
BB......BB............BB......BB
BB......BB............BB......BB
................................
................................
................................
................................
................................
................................
................................
................................
................................
......BB......BBBB......BB......
......BB......BBBB......BB......
................................
................................
................................
................................
................................
................................
................................
................................
.....BB.....BB....BB.....BB.....
.....BB.....BB....BB.....BB.....
................................
................................
................................
.........BBBB......BBBB.........
.........BBBB......BBBB.........
...........BB......BB...........
...........BB......BB...........
......BB...BB......BB...BB......
......BB...BB......BB...BB......
..BB..BB................BB..BB..
..BB..BB................BB..BB..
................................
................................
................................
................................
......BB................BB......
......BB................BB......
......BB................BB......
......BB................BB......
................................
................................
............BBBBBBBB............
............BBBBBBBB............
............BB....BB............
............BB....BB............
BBBB....BB............BB....BBBB
BBBB....BB............BB....BBBB
................................
................................
................................
........BBBB........BBBB........
........BBBB........BBBB........
........BB............BB........
........BB............BB........
..BBBB....................BBBB..
..BBBB....................BBBB..
..BB..........BBBB..........BB..
..BB..........BBBB..........BB..
........BBBB........BBBB........
........BBBB........BBBB........
..BBBB..BB............BB..BBBB..
..BBBB..BB............BB..BBBB..
........BB............BB........
........BB............BB........
........BB............BB........
........BB............BB........
................................
................................
..BBBB....BBBBBBBBBBBB....BBBB..
..BBBB....BBBBBBBBBBBB....BBBB..
................................
................................
................................
................................
................................
................................
................................
BBBBBBBBBBBBBBBBBBBBBBBB........
BBBBBBBBBBBBBBBBBBBBBBBB........
......................BB..BBBBBB
......................BB..BBBBBB
......................BB........
................BBBB..BB........
................BBBB............
..........BBBB..BB..............
..........BBBB..BB......BBBBBBBB
....BBBB..BB............BBBBBBBB
....BBBB..BB............BB......
BB..BB..................BB......
BB..BB..................BB......
............BB..........BB......
............BB..................
................................
................................
BBBBBBBBBBBBBBBBBBBBBBBBBBBBBBBB
BBBBBBBBBBBBBBBBBBBBBBBBBBBBBBBB
GGGGGGGGGGGGGGGGGGGGGGGGGGGGGGGG
GGGGGGGGGGGGGGGGGGGGGGGGGGGGGGGG
GGGBBGGGGGGGGGGGGGGGGGGGGGGGGGGG
GGGBBGGGGGGGGGGGGGGGGGGGGGGGGGGG
