................................
................................
................................
................................
................................
................................
................................
................................
................................
................................
................................
................................
................................
................................
................................
BBBBBBBBBBBBBBBBBBBBBBBBBBBBBBBB
BBBBBBBBBBBBBBBBBBBBBBBBBBBBBBBB
................................
................................
................................
................................
.............BBBBBBBB...........
.............BBBBBBBB...........
................................
................................
................................
................................
................................
................................
..................BBBBBBBBBB..BB
..................BBBBBBBBBB..BB
......................BB........
......................BB........
......................BB........
......................BB........
.....BBBBBBBB.........BB........
.....BBBBBBBB...................
.....BB.........................
.....BB.........................
BB...BB...........BBBBBBBBBBBBBB
BB...BB...........BBBBBBBBBBBBBB
BB....................BB.......B
BB....................BB.......B
BB....................BB.......B
BB...BBBBBBBB.........BB.......B
BB...BBBBBBBB.........BB.......B
................................
................................
................................
..................BBBBBBBBB.....
..................BBBBBBBBB.....
................................
.....BBBBBBBB...................
.....BBBBBBBB...................
................................
................................
.......BBBBBB.....BBBBBBBBBB..BB
.......BBBBBB.....BBBBBBBBBB..BB
......................BB........
......................BB........
......................BB........
......................BB........
.....BBBBBBBB.........BB........
.....BBBBBBBB...................
.....BB.........................
.....BB.........................
BB...BB...........BBBBBBBBBBBBBB
BB...BB...........BBBBBBBBBBBBBB
BB....................BB.......B
BB....................BB.......B
BB....................BB.......B
BB...BBBBBBBB.........BB.......B
BB...BBBBBBBB.........BB.......B
................................
................................
................................
..................BBBBBBBBBBBBBB
..................BBBBBBBBBBBBBB
................................
.....BBBBBBBB...................
.....BBBBBBBB...................
................................
................................
................................
..................BBBBB.........
..................BBBBB.........
................................
................................
.........BBBB...................
.........BBBB...................
................................
................................
BB...BBBBBBBB..........BBBBBBBBB
BB...BBBBBBBB..........BBBBBBBBB
................................
................................
................................
................................
.....BBBBBBBB...................
.....BBBBBBBB...................
................................
................................
................................
.................BBBBBBBBB......
.................BBBBBBBBB......
................................
................................
................................
.............................BBB
.............................BBB
................................
................................
.................BBBBBBBBB......
.................BBBBBBBBB......
................................
................................
.....BBBBBBBB...................
.....BBBBBBBB...................
................................
................................
................................
................................
................................
BBBBBB..........BBBBBBBBBBBBBBBB
BBBBBB..........BBBBBBBBBBBBBBBB
................................
................................
BBBBBBBBBBBBBBBBBBBBBBBBBBBBBBBB
BBBBBBBBBBBBBBBBBBBBBBBBBBBBBBBB
......GGGGGGGGGGGGGGGGGGGGGGGGGG
......GGGGGGGGGGGGGGGGGGGGGGGGGG
......GGGGGGGGGGGGGGGGGGGGGGGGGG
......GGGGGGGGGGGGGGGGGGGGGGGGGG
