................................
................................
................................
................................
................................
................................
................................
................................
................................
................................
................................
................................
................................
................................
................................
BBBBBBBBBBBBBBBBBBBBBBBBBBBBBBBB
BBBBBBBBBBBBBBBBBBBBBBBBBBBBBBBB
................................
................................
................................
................................
................................
................................
................................
................................
................................
................................
......BBBBBBBBBBBBBBBBBBBB......
......BBBBBBBBBBBBBBBBBBBB......
................................
................................
................................
BBBBBBBBBB............BBBBBBBBBB
BBBBBBBBBB............BBBBBBBBBB
................................
................................
................................
................................
BBBB....BBBBBB....BBBBBB....BBBB
BBBB....BBBBBB....BBBBBB....BBBB
................................
................................
................................
................................
BBBBBBBBBBBBBBBBBBBBBBBBBBBBBBBB
BBBBBBBBBBBBBBBBBBBBBBBBBBBBBBBB
................................
................................
.......BBBB..........BBBB.......
.......BBBB..........BBBB.......
................................
................................
................................
................................
......BBBBBBBBBBBBBBBBBBBB......
......BBBBBBBBBBBBBBBBBBBB......
................................
................................
................................
BBBBBBBBBB............BBBBBBBBBB
BBBBBBBBBB............BBBBBBBBBB
................................
................................
................................
................................
BBBB....BBBBBB....BBBBBB....BBBB
BBBB....BBBBBB....BBBBBB....BBBB
................................
................................
................................
....BBBBBB..BBBBBBBB..BBBBBB....
....BBBBBB..BBBBBBBB..BBBBBB....
................................
................................
................................
..................BBBBBB...BB...
..................BBBBBB...BB...
................................
......BBBBBB....................
......BBBBBB....................
...............BBBBBBBBBBBB.....
...............BBBBBBBBBBBB.....
................................
................................
................................
BBBBBBBBBB............BBBBBBBBBB
BBBBBBBBBB............BBBBBBBBBB
................................
................................
................................
................................
................................
......BBBBBBBB....BBBBBBBB......
......BBBBBBBB....BBBBBBBB......
................................
................................
................................
.........BBBBBBBBBBBBBB.........
.........BBBBBBBBBBBBBB.........
................................
................................
................................
....BBBBBBBB........BBBBBBBB....
....BBBBBBBB........BBBBBBBB....
................................
................................
................................
BBBBBBBBBBBBBBBBBBBBBBBBBBBBBBBB
BBBBBBBBBBBBBBBBBBBBBBBBBBBBBBBB
GGGGGGGGGGGGGGGGGGGGGGGGGGGGGGGG
GGGGGGGGGGGGGGGGGGGGGGGGGGGGGGGG
GGGGGGGGGGGGGGGGGGGGGGGGGGGGGGGG
GGGGGGGGGGGGGGGGGGGGGGGGGGGGGGGG
