................................
................................
................................
................................
................................
................................
................................
................................
................................
................................
................................
................................
................................
................................
................................
BBBBBBBBBBBBBBBBBBBBBBBBBBBBBBBB
BBBBBBBBBBBBBBBBBBBBBBBBBBBBBBBB
................................
................................
................................
........BBBB......BBBB..........
........BBBB......BBBB..........
................................
................................
................................
................................
................................
................................
................................
................................
................................
................................
.....BBBBBBBB...BBBBBBBB........
.....BBBBBBBB...BBBBBBBB........
................................
................................
................................
BBBBBBB...BBBBBBBB...BBBBB..BBBB
BBBBBBB...BBBBBBBB...BBBBB..BBBB
................................
................................
................................
......BBBBBBB...BBBBBB..........
......BBBBBBB...BBBBBB..........
................................
................................
................................
........BBBBBBBBBBBBBB.......BBB
........BBBBBBBBBBBBBB.......BBB
................................
................................
................................
................................
...BB..BB..BB..BBB..BB..BB..BB..
...BB..BB..BB..BBB..BB..BB..BB..
................................
................................
................................
................................
................................
................................
................................
................................
................................
................................
................................
................................
................................
................................
...BB..BB..BB..BBB..BB..BB..BB..
...BB..BB..BB..BBB..BB..BB..BB..
................................
................................
................................
................................
................................
................................
................................
................................
................................
................................
................................
..........BBBB..................
..........BBBB..................
................................
................................
................................
................................
................................
................................
................................
...........BB...................
...........BB...................
................................
................................
................................
...BB..BB..BB..BBB..BB..BB..BB..
...BB..BB..BB..BBB..BB..BB..BB..
................................
................................
................................
...BB..BB..BB..BBB..BB..BB..BB..
...BB..BB..BB..BBB..BB..BB..BB..
................................
................................
................................
................................
................................
................................
.......BB..BB..BBB..BB..BB......
.......BB..BB..BBB..BB..BB......
................................
................................
................................
...........BB..BBB..BB..........
...........BB..BBB..BB..........
................................
................................
................................
BB..........................BB..
BB..........................BB..
................................
................................
................................
...BB......BB..BBB..BB......BB..
...BB......BB..BBB..BB......BB..
................................
.......BB...............BB......
.......BB...............BB......
...BB......BB..BBB..BB......BB..
...BB......BB..BBB..BB......BB..
................................
................................
................................
................................
................................
BBBBBBBBBBBBB...BB..BB..BB......
BBBBBBBBBBBBB...BB..BB..BB......
BB..............BB..BB..BB......
BB......................BB......
BB......................BB......
BB..BBB.........BBBBBB..BB......
BB..BBB.........BBBBBB..BB......
BB..............................
BB..............................
BB..........................BBBB
BB.....BBBB.................BBBB
BB.....BBBB.................BBBB
................................
................................
................................
...BB..BBBBBB............BBBBBBB
...BB..BBBBBB............BBBBBBB
.......BB................BB.....
.......BB................BB.....
.......BB................BB.....
...BB..BB.........BBBBB..BB..BBB
...BB..BB.........BBBBB..BB..BBB
................................
................................
................................
................................
................................
BBBBBBBBBBBBB...BB..BB..BB......
BBBBBBBBBBBBB...BB..BB..BB......
BB..............................
BB..............................
BB..............................
BB..............................
BB..............................
BB..............................
................................
................................
BBBBBBBBBB.....BB....BBBBB....BB
BBBBBBBBBB.....BB....BBBBB....BB
.....................BB.........
.....................BB.........
.....................BB.........
.....................BB.........
...BB..BBBBBBBBBB........BBBBBBB
...BB..BBBBBBBBBB........BBBBBBB
.......BB................BB.....
.......BB................BB.....
.......BB................BB.....
...BB......BBBBBBBBBBBB..BB..BBB
...BB......BBBBBBBBBBBB..BB..BBB
................................
................................
................................
................................
................................
................................
...........BBBBBBBBBBBBB........
...........BBBBBBBBBBBBB........
.............BB.................
.............BB.................
..BBBB..........................
..BBBB..........................
.............BBBBBBB....BBBBBBBB
.............BBBBBBB....BBBBBBBB
.............BB.................
BBBB.........BB.................
BBBB.........BB.................
..BB.........BB...BBBBBBBB......
..BB.........BB...BBBBBBBB......
................................
................................
................................
................................
BBBBBBBBBBBBBBBBBBBBBBBBBBBBBBBB
BBBBBBBBBBBBBBBBBBBBBBBBBBBBBBBB
GGGGGGGGGGGGGGGGGGGGGGGGGGGGGGGG
GGGGGGGGGGGGGGGGGGGGGGGGGGGGGGGG
GGGGGGGGGGGGGGGGGGGGGGGGGGGGGGGG
GGGGGGGGGGGGGGGGGGGGGGGGGGGGGGGG
