................................
................................
................................
....BBB.......BBBB.......BBB....
....BBB.......BBBB.......BBB....
................................
................................
................................
....BBB.......BBBB.......BBB....
....BBB.......BBBB.......BBB....
................................
................................
................................
....BBB.......BBBB.......BBB....
....BBB.......BBBB.......BBB....
................................
................................
................................
BBBBBBBBBBBBBBBBBBBBBBBBBBBBBBBB
BBBBBBBBBBBBBBBBBBBBBBBBBBBBBBBB
................................
................................
................................
................................
................................
................................
................................
................................
................................
................................
.........BBBBBBBBBBBBBB.........
.........BBBBBBBBBBBBBB.........
.........BB..........BB.........
.........BB..........BB.........
.........BB..........BB.........
.........BB..........BB.........
................................
................................
................................
................................
....BBBBBBBBBBB..BBBBBBBBBBB....
....BBBBBBBBBBB..BBBBBBBBBBB....
....BB.......BB..BB.......BB....
....BB.......BB..BB.......BB....
....BB.......BB..BB.......BB....
....BB.......BB..BB.......BB....
................................
................................
................................
BBBBBB....BBBBBBBBBBBB....BBBBBB
BBBBBB....BBBBBBBBBBBB....BBBBBB
....BB....BB........BB....BB....
....BB....BB........BB....BB....
....BB....BB........BB....BB....
....BB....BB........BB....BB....
................................
................................
................................
................................
................................
BBBBBBBBBBBBBBB...BBBBBBBBBBBBBB
BBBBBBBBBBBBBBB...BBBBBBBBBBBBBB
............BB......BB..........
............BB......BB..........
............BB......BB..........
............BB......BB..........
................................
................................
................................
BBBBBBBBBB..BB......BB..BBBBBBBB
BBBBBBBBBB..BB......BB..BBBBBBBB
....BB....................BB....
....BB....................BB....
....BB....................BB....
....BB....................BB....
................................
................................
BBBBBBBBBB....BBBBBB....BBBBBBBB
BBBBBBBBBB....BBBBBB....BBBBBBBB
................................
................................
................................
................................
................................
................................
................................
............BB....BB............
............BB....BB............
................................
................................
.........BB..........BB.........
.........BB..........BB.........
................................
................................
................................
..............BBBB..............
..............BBBB..............
......BBBBB..........BBBBB......
......BBBBB..........BBBBB......
...BB......................BB...
...BB......................BB...
................................
................................
BB............................BB
BB............................BB
................................
................................
................................
................................
................................
................................
................................
BB.............BBBB...........BB
BB.............BBBB...........BB
................................
................................
....BB.....................BB...
....BB.....................BB...
................................
................................
.......BB...............BB......
.......BB...............BB......
................................
................................
....BB.....................BB...
....BB.....................BB...
................................
................................
BB.............BBBB...........BB
BB.............BBBB...........BB
................................
................................
................................
................................
................................
................................
................................
BBBBBBBBBBBBBBBBBB....BBBBBBBBBB
BBBBBBBBBBBBBBBBBB....BBBBBBBBBB
....BB....BB..........BB........
....BB....BB..........BB........
....BB....BB..........BB........
................................
................................
..BBBB....BBBBBBB.....BBBBBBBBBB
..BBBB....BBBBBBB.....BBBBBBBBBB
....BB................BB......BB
....BB................BB......BB
................................
................................
BBBBBBBBBB............BB....BBBB
BBBBBBBBBB............BB....BBBB
....BB................BB........
....BB................BB........
................................
................................
BBBBBB......BBBBB.....BBBB......
BBBBBB......BBBBB.....BBBB......
................................
................................
.............BBBBB..............
.............BBBBB..............
................................
................................
........BBBBB.....BBBBB.........
........BBBBB.....BBBBB.........
................................
................................
.....BBBB.............BBBB......
.....BBBB.............BBBB......
................................
................................
...BBBB.................BBBB....
...BBBB.................BBBB....
................................
................................
................................
................................
BBBBBBBBBBBBBBBBBBBBBBBBBBBBBBBB
BBBBBBBBBBBBBBBBBBBBBBBBBBBBBBBB
BBBBBBBBBBBBBBBBBBBBBBBBBBBBBBBB
................................
................................
................................
................................
................................
................................
................................
BBB....BBBBBB....BBBBBB....BBBBB
BBB....BBBBBB....BBBBBB....BBBBB
BBB....BBBBBB....BBBBBB....BBBBB
................................
................................
................................
BBBBBBBBBBBB.....BBBBBBBBBBBBB..
BBBBBBBBBBBB.....BBBBBBBBBBBBB..
BBBBBBBBBBBB.....BBBBBBBBBBBBB..
................................
................................
................................
BBB....BBBBBB....BBBBBB....BBBBB
BBB....BBBBBB....BBBBBB....BBBBB
BBB....BBBBBB....BBBBBB....BBBBB
................................
................................
................................
BBBBBBBBBBBBBBBBBBBBBBBBBBBBBB..
BBBBBBBBBBBBBBBBBBBBBBBBBBBBBB..
BBBBBBBBBBBBBBBBBBBBBBBBBBBBBB..
................................
................................
................................
................................
................................
................................
BBB....BBBBBB....BBBBBB....BBBBB
BBB....BBBBBB....BBBBBB....BBBBB
BBB....BBBBBB....BBBBBB....BBBBB
................................
................................
................................
..BBBBBB....BBBBBB....BBBBBB....
..BBBBBB....BBBBBB....BBBBBB....
..BBBBBB....BBBBBB....BBBBBB....
................................
................................
................................
BBB....BBBBBB....BBBBBB....BBBBB
BBB....BBBBBB....BBBBBB....BBBBB
BBB....BBBBBB....BBBBBB....BBBBB
................................
................................
................................
..BBBBBB....BBBBBB....BBBBBB....
..BBBBBB....BBBBBB....BBBBBB....
..BBBBBB....BBBBBB....BBBBBB....
................................
................................
................................
................................
................................
................................
................................
BBBBBBBBBBBBBBBBBBBBBBBBBBBBBBBB
BBBBBBBBBBBBBBBBBBBBBBBBBBBBBBBB
BBBBBBBBBBBBBBBBBBBBBBBBBBBBBBBB
GGGGGGGGGGGGGGGGGGGGGGGGGGGGGGGG
GGGGGGGGGGGGGGGGGGGGGGGGGGGGGGGG
GGGGGGGGGGGGGGGGGGGGGGGGGGGGGGGG
GGGGGGGGGGGGGGGGGGGGGGGGGGGGGGGG
